N;N;N;N;N;N;N;N;N;N;N;N;N;N;N;N;N;N;N;N;N;N;N
N;O;O;O;O;O;O;O;O;O;O;O;O;O;O;O;O;O;O;O;O;O;N
N;O;N;O;N;O;N;O;N;O;N;O;N;O;N;O;N;O;N;O;N;O;N
N;O;O;O;O;O;O;N;N;O;N;O;N;O;N;N;O;O;O;O;O;O;N
N;O;N;O;N;N;O;O;O;O;N;O;O;O;O;O;O;N;N;O;N;O;N
N;O;O;O;N;N;N;O;N;O;O;O;N;O;N;N;O;N;N;O;O;O;N
N;O;N;O;O;O;O;O;O;N;N;O;O;O;O;O;O;O;O;O;N;O;N
N;O;O;O;N;O;N;N;O;N;N;O;N;O;N;O;N;O;N;O;O;O;N
N;O;N;O;O;O;O;O;O;O;O;O;O;O;O;O;O;O;O;O;N;O;N
N;O;O;N;N;O;N;N;O;N;N;O;N;O;N;O;N;O;N;O;O;O;N
N;O;N;N;O;O;O;O;O;N;N;O;O;O;O;O;O;O;N;O;N;O;N
N;O;O;N;N;O;N;N;O;N;N;O;N;O;N;O;N;O;N;O;O;O;N
N;O;N;O;O;O;O;O;O;O;O;O;N;O;N;O;O;O;O;O;N;O;N
N;O;O;O;N;O;N;O;N;O;N;O;O;O;O;N;N;O;N;N;O;O;N
N;O;N;O;O;O;O;O;O;O;O;O;N;N;O;O;O;O;O;O;N;O;N
N;O;O;O;N;N;N;O;N;O;N;O;N;N;O;N;N;O;N;O;O;O;N
N;O;N;O;O;N;O;O;O;O;O;O;O;O;O;O;O;O;O;O;N;O;N
N;O;N;N;O;N;O;N;O;N;O;N;O;N;O;N;O;N;O;N;N;O;N
N;O;O;O;O;O;O;O;O;O;O;O;O;O;O;O;O;O;O;O;O;O;N
N;N;N;N;N;N;N;N;N;N;N;N;N;N;N;N;N;N;N;N;N;N;N
